[['#', '#', '#', '#', '#', '#', '#', '#', '#', '#', '#'],
 ['#', ' ', ' ', ' ', ' ', ' ', '#', ' ', ' ', '#', '#'],
 ['#', ' ', '#', ' ', ' ', ' ', ' ', ' ', ' ', '#', '#'],
 ['#', ' ', ' ', ' ', 'X', ' ', '#', ' ', ' ', '#', '#'],
 ['#', ' ', ' ', '#', ' ', ' ', 'C', ' ', ' ', ' ', '#'],
 ['#', ' ', ' ', 'P', ' ', ' ', ' ', ' ', ' ', ' ', '#'],
 ['#', '#', 'X', ' ', '#', ' ', ' ', '#', ' ', '#', '#'],
 ['#', '#', ' ', ' ', '#', '#', '#', '#', 'C', ' ', '#'],
 ['#', ' ', ' ', ' ', ' ', ' ', ' ', ' ', ' ', ' ', '#'],
 ['#', ' ', ' ', ' ', '#', '#', '#', ' ', ' ', '#', '#'],
 ['#', '#', '#', '#', '#', '#', '#', '#', '#', '#', '#']]