[['#', '#', '#', '#', '#', '#', '#', '#', '#', '#', '#'],
 ['#', ' ', ' ', 'P', '#', '#', '#', '#', '#', '#', '#'],
 ['#', ' ', '#', 'C', '#', '#', '#', '#', '#', '#', '#'],
 ['#', ' ', ' ', ' ', '#', '#', '#', '#', '#', '#', '#'],
 ['#', '#', ' ', ' ', ' ', ' ', ' ', ' ', ' ', ' ', '#'],
 ['#', 'X', ' ', 'X', ' ', '#', ' ', ' ', ' ', ' ', '#'],
 ['#', ' ', ' ', '#', ' ', ' ', ' ', '#', ' ', '#', '#'],
 ['#', ' ', 'C', '#', '#', 'X', '#', ' ', 'C', ' ', '#'],
 ['#', ' ', ' ', ' ', ' ', ' ', ' ', ' ', ' ', ' ', '#'],
 ['#', '#', ' ', ' ', ' ', ' ', ' ', ' ', ' ', ' ', '#'],
 ['#', '#', '#', '#', '#', '#', '#', '#', '#', '#', '#']]