[['#', '#', '#', '#', '#', '#', '#', '#', '#', '#', '#'],
 ['#', ' ', ' ', ' ', 'X', ' ', ' ', '#', '#', '#', '#'],
 ['#', ' ', ' ', ' ', ' ', ' ', ' ', '#', '#', '#', '#'],
 ['#', '#', '#', '#', ' ', ' ', ' ', 'C', ' ', ' ', '#'],
 ['#', ' ', 'C', ' ', ' ', ' ', '#', ' ', 'X', ' ', '#'],
 ['#', ' ', 'C', ' ', ' ', ' ', '#', '#', ' ', '#', '#'],
 ['#', ' ', ' ', '#', ' ', ' ', ' ', ' ', ' ', ' ', '#'],
 ['#', ' ', ' ', 'X', '#', ' ', ' ', ' ', ' ', ' ', '#'],
 ['#', 'P', ' ', ' ', ' ', ' ', ' ', '#', '#', '#', '#'],
 ['#', ' ', ' ', ' ', ' ', ' ', '#', '#', '#', '#', '#'],
 ['#', '#', '#', '#', '#', '#', '#', '#', '#', '#', '#']]