[['#', '#', '#', '#', '#', '#', '#', '#', '#', '#', '#'],
 ['#', '#', ' ', 'C', 'X', ' ', ' ', '#', '#', '#', '#'],
 ['#', '#', 'X', ' ', ' ', ' ', ' ', '#', '#', '#', '#'],
 ['#', '#', ' ', ' ', ' ', '#', '#', '#', '#', '#', '#'],
 ['#', '#', '#', ' ', 'C', ' ', '#', ' ', ' ', ' ', '#'],
 ['#', ' ', ' ', ' ', ' ', ' ', ' ', ' ', ' ', ' ', '#'],
 ['#', ' ', ' ', ' ', '#', ' ', '#', '#', '#', '#', '#'],
 ['#', '#', '#', '#', '#', ' ', ' ', '#', '#', '#', '#'],
 ['#', '#', '#', '#', ' ', ' ', ' ', '#', '#', '#', '#'],
 ['#', '#', '#', '#', ' ', 'P', ' ', '#', '#', '#', '#'],
 ['#', '#', '#', '#', '#', '#', '#', '#', '#', '#', '#']]