[['#', '#', '#', '#', '#', '#', '#', '#', '#', '#', '#'],
 ['#', '#', '#', '#', ' ', ' ', '#', '#', '#', '#', '#'],
 ['#', '#', '#', '#', ' ', ' ', '#', ' ', ' ', '#', '#'],
 ['#', '#', '#', '#', ' ', ' ', ' ', ' ', ' ', '#', '#'],
 ['#', '#', 'P', 'X', ' ', 'C', ' ', '#', ' ', '#', '#'],
 ['#', ' ', ' ', ' ', ' ', ' ', ' ', ' ', ' ', '#', '#'],
 ['#', ' ', ' ', '#', '#', ' ', ' ', '#', '#', '#', '#'],
 ['#', '#', ' ', ' ', '#', ' ', ' ', '#', '#', '#', '#'],
 ['#', '#', ' ', ' ', 'C', ' ', ' ', ' ', 'X', ' ', '#'],
 ['#', '#', '#', '#', ' ', ' ', '#', ' ', ' ', ' ', '#'],
 ['#', '#', '#', '#', '#', '#', '#', '#', '#', '#', '#']]