[['#', '#', '#', '#', '#', '#', '#', '#', '#', '#', '#'],
 ['#', '#', '#', '#', '#', '#', '#', '#', '#', '#', '#'],
 ['#', '#', '#', '#', '#', '#', '#', '#', '#', '#', '#'],
 ['#', ' ', ' ', ' ', '#', '#', '#', '#', '#', '#', '#'],
 ['#', ' ', ' ', ' ', 'C', ' ', '#', ' ', ' ', '#', '#'],
 ['#', ' ', 'X', ' ', ' ', ' ', ' ', ' ', 'X', ' ', '#'],
 ['#', '#', ' ', '#', '#', ' ', '#', '#', ' ', 'P', '#'],
 ['#', ' ', 'C', ' ', 'X', ' ', '#', '#', ' ', ' ', '#'],
 ['#', ' ', '#', ' ', ' ', ' ', ' ', ' ', 'C', ' ', '#'],
 ['#', ' ', ' ', ' ', ' ', ' ', '#', '#', ' ', ' ', '#'],
 ['#', '#', '#', '#', '#', '#', '#', '#', '#', '#', '#']]