[['#', '#', '#', '#', '#', '#', '#', '#', '#', '#', '#'],
 ['#', '#', '#', '#', '#', '#', '#', ' ', ' ', ' ', '#'],
 ['#', '#', '#', '#', ' ', ' ', '#', ' ', ' ', ' ', '#'],
 ['#', '#', '#', '#', ' ', ' ', '#', '#', 'P', '#', '#'],
 ['#', '#', '#', ' ', ' ', ' ', '#', '#', ' ', '#', '#'],
 ['#', '#', '#', ' ', ' ', ' ', ' ', ' ', ' ', ' ', '#'],
 ['#', '#', '#', ' ', ' ', 'C', 'C', ' ', ' ', 'X', '#'],
 ['#', '#', '#', '#', '#', '#', ' ', ' ', '#', '#', '#'],
 ['#', '#', '#', '#', ' ', 'C', ' ', 'X', ' ', '#', '#'],
 ['#', '#', '#', '#', 'X', ' ', ' ', ' ', ' ', '#', '#'],
 ['#', '#', '#', '#', '#', '#', '#', '#', '#', '#', '#']]