[['#', '#', '#', '#', '#', '#', '#', '#', '#', '#', '#'],
 ['#', ' ', ' ', ' ', ' ', ' ', '#', ' ', ' ', '#', '#'],
 ['#', ' ', '#', ' ', ' ', ' ', ' ', ' ', ' ', '#', '#'],
 ['#', ' ', ' ', ' ', ' ', 'X', '#', ' ', 'C', '#', '#'],
 ['#', ' ', ' ', '#', ' ', 'X', ' ', ' ', ' ', ' ', '#'],
 ['#', ' ', 'C', ' ', ' ', ' ', 'P', ' ', ' ', ' ', '#'],
 ['#', '#', ' ', ' ', '#', ' ', ' ', '#', ' ', '#', '#'],
 ['#', '#', ' ', ' ', '#', '#', '#', '#', ' ', ' ', '#'],
 ['#', ' ', ' ', ' ', ' ', ' ', ' ', ' ', ' ', ' ', '#'],
 ['#', ' ', ' ', ' ', '#', '#', '#', ' ', ' ', '#', '#'],
 ['#', '#', '#', '#', '#', '#', '#', '#', '#', '#', '#']]