[['#', '#', '#', '#', '#', '#', '#', '#', '#', '#', '#'],
 ['#', '#', ' ', ' ', 'C', ' ', 'X', '#', '#', '#', '#'],
 ['#', '#', ' ', ' ', ' ', ' ', ' ', '#', '#', '#', '#'],
 ['#', '#', ' ', ' ', ' ', '#', '#', '#', '#', '#', '#'],
 ['#', '#', '#', ' ', ' ', ' ', '#', ' ', ' ', ' ', '#'],
 ['#', ' ', ' ', 'P', ' ', 'X', ' ', ' ', ' ', ' ', '#'],
 ['#', ' ', ' ', ' ', '#', ' ', '#', '#', '#', '#', '#'],
 ['#', '#', '#', '#', '#', ' ', ' ', '#', '#', '#', '#'],
 ['#', '#', '#', '#', ' ', 'C', ' ', '#', '#', '#', '#'],
 ['#', '#', '#', '#', ' ', ' ', ' ', '#', '#', '#', '#'],
 ['#', '#', '#', '#', '#', '#', '#', '#', '#', '#', '#']]